NO ./textures/bluestone.xpm
SO        ./textures/colorstone.xpm
WE  ./textures/greystone.xpm
EA ./textures/mossy.xpm

F 115,207,85
C 100,150,232   

        111111111
   0    1011000011
        100000E001
11111111111111111
