NO ./path_to_the_north_texture
SO        ./path_to_the_south_texture
WE  ./path_to_the_west_texture
EA ./path_to_the_east_texture

F 115,207,85
C 100,150,232   

        1111111111
   0    1011000011
        100000E001
11111111111111111
