NO ./path_to_the_north_texture
SO        ./path_to_the_south_texture
WE  ./path_to_the_west_texture
EA ./path_to_the_east_texture

F 115,207,85
C 100,150,232   

11111
10001
1001
10001
11111

11111
10001
10N01
10001
1111