   NO ./textures/redbrick.xpm
SO        ./textures/colorstone.xpm
      WE  ./textures/wood.xpm
EA ./textures/wood.xpm

		F	 49, 51, 56 		
   C 			  			96, 99, 107		

111111111111111111111111111111111
1000000000000N0000000000000000001
111111111101111111111111100111111
        1001            1011
        1011            101
        1111            101
                        101
                        101
                        1011
                        1001111111111111111111111
                        1000000000000000000000001
                        1011111111111111111111111
                        101
                        101
                111111111001
                100000000001
                100000000001
                100000000001
                100000000001
                100000000001
                111111111111