NO ./textures/bluestone.xpm
SO        ./textures/colorstone.xpm
WE  ./textures/greystone.xpm
EA ./textures/mossy.xpm

F 220,100,0
C 225,30,0

111
10111111111
1000000N001
10111010001
10000000001
11111111111
