NO ./textures/bluestone.xpm
SO        ./textures/colorstone.xpm
WE  ./textures/greystone.xpm
EA ./textures/mossy.xpm

F 220,100,0
C 225,30,0

111111111
100000N01
101101001
100000001
111111111
