NO ./textures/eagle.xpm
SO        ./textures/eagle.xpm
WE  ./textures/eagle.xpm
EA ./textures/eagle.xpm

F 115,207,85
C 100,150,232   

11111111111111111111111                                 111111111111111111111111111111111111111111111111111111111111111111111111111111111111
10000000000000000000001                                 100000000000000000000000000000000000000000000000000000000000000000000000000000000001
10000000000000E00000001                                 100000000000000000000000000000000000000000000000000000000000000000000000000000000001
10000000000000000000001                                 100000000000000000000000000000000000000000000000000000000000000000000000000000000001
11111111111111111111111                                 111111111111111111111111111111111111111111111111111111111111111111111111111111111111